10
10
NE5N6N1H4E
3H5N6H1N4N
3353631343
NC5H6NCN4N
7757671747
CR5N6H1E4N
885868884R
CE5N6N1R4N
2252621242
NN5N6N1H4R
